㑮	㑮	𫝈
㑯	㑯	㑔
㑳	㑳	㑇
㑶	㑶	㐹
㒓	㒓	𠉂
㓄	㓄	𪠟
㓨	㓨	刾
㔋	㔋	𪟎
㖮	㖮	𪠵
㗲	㗲	𠵾
㗿	㗿	𪡛
㘉	㘉	𠰱
㘓	㘓	𪢌
㘔	㘔	𫬐
㘚	㘚	㘎
㛝	㛝	𫝦
㜄	㜄	㚯
㜏	㜏	㛣
㜐	㜐	𫝧
㜗	㜗	𡞋
㜢	㜢	𡞱
㜷	㜷	𡝠
㞞	㞞	𪨊
㟺	㟺	𪩇
㠏	㠏	㟆
㢗	㢗	𪪑
㢝	㢝	𢋈
㥮	㥮	㤘
㦎	㦎	𢛯
㦛	㦛	𢗓
㦞	㦞	𪫷
㨻	㨻	𪮃
㩋	㩋	𪮋
㩜	㩜	㨫
㩳	㩳	㧐
㩵	㩵	擜
㪎	㪎	𪯋
㯤	㯤	𣘐
㰙	㰙	𣗙
㵗	㵗	𣳆
㵾	㵾	𪷍
㶆	㶆	𫞛
㷍	㷍	𤆢
㷿	㷿	𤈷
㸇	㸇	𤎺
㹽	㹽	𫞣
㺏	㺏	𤠋
㺜	㺜	𪺻
㻶	㻶	𪼋
㿖	㿖	𪽮
㿗	㿗	𤻊
㿧	㿧	𤽯
䀉	䀉	𥁢
䀹	䀹	𥅴
䁪	䁪	𥇢
䁻	䁻	䀥
䂎	䂎	𥎝
䃮	䃮	鿎
䅐	䅐	𫀨
䅳	䅳	𫀬
䆉	䆉	𫁂
䉑	䉑	𫁲
䉙	䉙	𥬀
䉬	䉬	𫂈
䉲	䉲	𥮜
䉶	䉶	𫁷
䊭	䊭	𥺅
䊷	䊷	䌶
䊺	䊺	𫄚
䋃	䋃	𫄜
䋔	䋔	𫄞
䋙	䋙	䌺
䋚	䋚	䌻
䋦	䋦	𫄩
䋹	䋹	䌿
䋻	䋻	䌾
䋼	䋼	𫄮
䋿	䋿	𦈓
䌈	䌈	𦈖
䌋	䌋	𦈘
䌖	䌖	𦈜
䌝	䌝	𦈟
䌟	䌟	𦈞
䌥	䌥	𦈠
䌰	䌰	𦈙
䍤	䍤	𫅅
䍦	䍦	䍠
䍽	䍽	𦍠
䎙	䎙	𫅭
䎱	䎱	䎬
䕤	䕤	𫟕
䕳	䕳	𦰴
䖅	䖅	𫟑
䗅	䗅	𫊪
䗿	䗿	𧉞
䙔	䙔	𫋲
䙡	䙡	䙌
䙱	䙱	𧜭
䚩	䚩	𫌯
䛄	䛄	𫍠
䛳	䛳	𫍫
䜀	䜀	䜧
䜖	䜖	𫟢
䝭	䝭	𫎧
䝻	䝻	𧹕
䝼	䝼	䞍
䞈	䞈	𧹑
䞋	䞋	𫎪
䞓	䞓	𫎭
䟃	䟃	𫎺
䟆	䟆	𫎳
䟐	䟐	𫎱
䠆	䠆	𫏃
䠱	䠱	𨅛
䡐	䡐	𫟤
䡩	䡩	𫟥
䡵	䡵	𫟦
䢨	䢨	𨑹
䤤	䤤	𫟺
䥄	䥄	𫠀
䥇	䥇	䦂
䥑	䥑	鿏
䥗	䥗	𫔋
䥩	䥩	𨱖
䥯	䥯	𫔆
䥱	䥱	䥾
䦘	䦘	𨸄
䦛	䦛	䦶
䦟	䦟	䦷
䦯	䦯	𫔵
䦳	䦳	𨷿
䧢	䧢	𨸟
䪊	䪊	𫖅
䪏	䪏	𩏼
䪗	䪗	𩐀
䪘	䪘	𩏿
䪴	䪴	𫖫
䪾	䪾	𫖬
䫀	䫀	𫖱
䫂	䫂	𫖰
䫟	䫟	𫖲
䫴	䫴	𩖗
䫶	䫶	𫖺
䫻	䫻	𫗇
䫾	䫾	𫠈
䬓	䬓	𫗊
䬘	䬘	𩙮
䬝	䬝	𩙯
䬞	䬞	𩙧
䬧	䬧	𫗟
䭀	䭀	𩠇
䭃	䭃	𩠈
䭑	䭑	𫗱
䭔	䭔	𫗰
䭿	䭿	𩧭
䮄	䮄	𫠊
䮝	䮝	𩧰
䮞	䮞	𩨁
䮠	䮠	𩧿
䮫	䮫	𩨇
䮰	䮰	𫘮
䮳	䮳	𩨏
䮾	䮾	𩧪
䯀	䯀	䯅
䯤	䯤	𩩈
䰾	䰾	鲃
䱀	䱀	𫚐
䱁	䱁	𫚏
䱙	䱙	𩾈
䱧	䱧	𫚠
䱬	䱬	𩾊
䱰	䱰	𩾋
䱷	䱷	䲣
䱸	䱸	𫠑
䱽	䱽	䲝
䲁	䲁	鳚
䲅	䲅	𫚜
䲖	䲖	𩾂
䲘	䲘	鳤
䲰	䲰	𪉂
䳜	䳜	𫛬
䳢	䳢	𫛰
䳤	䳤	𫛮
䳧	䳧	𫛺
䳫	䳫	𫛼
䴉	䴉	鹮
䴋	䴋	𫜅
䴬	䴬	𪎈
䴱	䴱	𫜒
䴴	䴴	𪎋
䴽	䴽	𫜔
䵳	䵳	𪑅
䵴	䵴	𫜙
䶕	䶕	𫜨
䶲	䶲	𫜳
丟	丟	丢
並	並	并
乾	乾	干 乾
亂	亂	乱
亙	亙	亘
亞	亞	亚
佇	佇	伫
佈	佈	布
佔	佔	占
併	併	并
來	來	来
侖	侖	仑
侶	侶	侣
侷	侷	局
俁	俁	俣
係	係	系
俓	俓	𠇹
俔	俔	伣
俠	俠	侠
俥	俥	伡
俬	俬	私
倀	倀	伥
倆	倆	俩
倈	倈	俫
倉	倉	仓
個	個	个
們	們	们
倖	倖	幸
倫	倫	伦
倲	倲	㑈
偉	偉	伟
偑	偑	㐽
側	側	侧
偵	偵	侦
偽	偽	伪
傌	傌	㐷
傑	傑	杰
傖	傖	伧
傘	傘	伞
備	備	备
傢	傢	家
傭	傭	佣
傯	傯	偬
傳	傳	传
傴	傴	伛
債	債	债
傷	傷	伤
傾	傾	倾
僂	僂	偻
僅	僅	仅
僉	僉	佥
僑	僑	侨
僕	僕	仆
僞	僞	伪
僥	僥	侥
僨	僨	偾
僱	僱	雇
價	價	价
儀	儀	仪
儁	儁	俊
儂	儂	侬
億	億	亿
儈	儈	侩
儉	儉	俭
儎	儎	傤
儐	儐	傧
儔	儔	俦
儕	儕	侪
儘	儘	尽 侭
償	償	偿
儣	儣	𠆲
優	優	优
儭	儭	𠋆
儲	儲	储
儷	儷	俪
儸	儸	㑩
儺	儺	傩
儻	儻	傥
儼	儼	俨
兇	兇	凶
兌	兌	兑
兒	兒	儿
兗	兗	兖
內	內	内
兩	兩	两
冊	冊	册
冑	冑	胄
冪	冪	幂
凈	凈	净
凍	凍	冻
凙	凙	𪞝
凜	凜	凛
凱	凱	凯
別	別	别
刪	刪	删
剄	剄	刭
則	則	则
剋	剋	克
剎	剎	刹
剗	剗	刬
剛	剛	刚
剝	剝	剥
剮	剮	剐
剴	剴	剀
創	創	创
剷	剷	铲
剾	剾	𠛅
劃	劃	划 㓰
劇	劇	剧
劉	劉	刘
劊	劊	刽
劌	劌	刿
劍	劍	剑
劏	劏	㓥
劑	劑	剂
劚	劚	㔉
勁	勁	劲
勑	勑	𠡠
動	動	动
務	務	务
勛	勛	勋
勝	勝	胜
勞	勞	劳
勢	勢	势
勣	勣	𪟝
勩	勩	勚
勱	勱	劢
勳	勳	勋
勵	勵	励
勸	勸	劝
勻	勻	匀
匭	匭	匦
匯	匯	汇
匱	匱	匮
區	區	区
協	協	协
卹	卹	恤
卻	卻	却
卽	卽	即
厙	厙	厍
厠	厠	厕
厤	厤	历
厭	厭	厌
厲	厲	厉
厴	厴	厣
參	參	参
叄	叄	叁
叢	叢	丛
吒	吒	咤
吳	吳	吴
吶	吶	呐
呂	呂	吕
咼	咼	呙
員	員	员
哯	哯	𠯟
唄	唄	呗
唓	唓	𪠳
唸	唸	念
問	問	问
啓	啓	启
啞	啞	哑
啟	啟	启
啢	啢	唡
喎	喎	㖞
喚	喚	唤
喪	喪	丧
喫	喫	吃
喬	喬	乔
單	單	单
喲	喲	哟
嗆	嗆	呛
嗇	嗇	啬
嗊	嗊	唝
嗎	嗎	吗
嗚	嗚	呜
嗩	嗩	唢
嗰	嗰	𠮶
嗶	嗶	哔
嗹	嗹	𪡏
嘆	嘆	叹
嘍	嘍	喽
嘓	嘓	啯
嘔	嘔	呕
嘖	嘖	啧
嘗	嘗	尝
嘜	嘜	唛
嘩	嘩	哗
嘪	嘪	𪡃
嘮	嘮	唠
嘯	嘯	啸
嘰	嘰	叽
嘳	嘳	𪡞
嘵	嘵	哓
嘸	嘸	呒
嘺	嘺	𪡀
嘽	嘽	啴
噁	噁	恶
噅	噅	𠯠
噓	噓	嘘
噚	噚	㖊
噝	噝	咝
噞	噞	𪡋
噠	噠	哒
噥	噥	哝
噦	噦	哕
噯	噯	嗳
噲	噲	哙
噴	噴	喷
噸	噸	吨
噹	噹	当 𪠽
嚀	嚀	咛
嚇	嚇	吓
嚌	嚌	哜
嚐	嚐	尝
嚕	嚕	噜
嚙	嚙	啮
嚛	嚛	𪠸
嚥	嚥	咽
嚦	嚦	呖
嚧	嚧	𠰷
嚨	嚨	咙
嚮	嚮	向
嚲	嚲	亸
嚳	嚳	喾
嚴	嚴	严
嚶	嚶	嘤
嚽	嚽	𪢕
囀	囀	啭
囁	囁	嗫
囂	囂	嚣
囃	囃	𠱞
囅	囅	冁
囈	囈	呓
囉	囉	啰
囌	囌	苏
囑	囑	嘱
囒	囒	𪢠
囪	囪	囱
圇	圇	囵
國	國	国
圍	圍	围
園	園	园
圓	圓	圆
圖	圖	图
團	團	团
圞	圞	𪢮
埡	埡	垭
埬	埬	𪣆
埰	埰	采
執	執	执
堅	堅	坚
堊	堊	垩
堖	堖	垴
堚	堚	𪣒
堝	堝	埚
堯	堯	尧
報	報	报
場	場	场
塊	塊	块
塋	塋	茔
塏	塏	垲
塒	塒	埘
塗	塗	涂
塚	塚	冢
塢	塢	坞
塤	塤	埙
塵	塵	尘
塹	塹	堑
塿	塿	𪣻
墊	墊	垫
墜	墜	坠
墮	墮	堕
墰	墰	坛
墲	墲	𪢸
墳	墳	坟
墶	墶	垯
墻	墻	墙
墾	墾	垦
壇	壇	坛
壈	壈	𡒄
壋	壋	垱
壎	壎	埙
壓	壓	压
壗	壗	𡋤
壘	壘	垒
壙	壙	圹
壚	壚	垆
壜	壜	坛
壞	壞	坏
壟	壟	垄
壠	壠	垅
壢	壢	坜
壣	壣	𪤚
壩	壩	坝
壪	壪	塆
壯	壯	壮
壺	壺	壶
壼	壼	壸
壽	壽	寿
夠	夠	够
夢	夢	梦
夥	夥	伙 夥
夾	夾	夹
奐	奐	奂
奧	奧	奥
奩	奩	奁
奪	奪	夺
奬	奬	奖
奮	奮	奋
奼	奼	姹
妝	妝	妆
姍	姍	姗
姦	姦	奸
娛	娛	娱
婁	婁	娄
婡	婡	𫝫
婦	婦	妇
婭	婭	娅
媈	媈	𫝨
媧	媧	娲
媯	媯	妫
媰	媰	㛀
媼	媼	媪
媽	媽	妈
嫋	嫋	袅
嫗	嫗	妪
嫵	嫵	妩
嫺	嫺	娴
嫻	嫻	娴
嫿	嫿	婳
嬀	嬀	妫
嬃	嬃	媭
嬇	嬇	𫝬
嬈	嬈	娆
嬋	嬋	婵
嬌	嬌	娇
嬙	嬙	嫱
嬡	嬡	嫒
嬣	嬣	𪥰
嬤	嬤	嬷
嬦	嬦	𫝩
嬪	嬪	嫔
嬰	嬰	婴
嬸	嬸	婶
嬻	嬻	𪥿
孃	孃	娘
孄	孄	𫝮
孆	孆	𫝭
孇	孇	𪥫
孋	孋	㛤
孌	孌	娈
孎	孎	𡠟
孫	孫	孙
學	學	学
孻	孻	𡥧
孾	孾	𪧀
孿	孿	孪
宮	宮	宫
寀	寀	采
寠	寠	𪧘
寢	寢	寝
實	實	实
寧	寧	宁
審	審	审
寫	寫	写
寬	寬	宽
寵	寵	宠
寶	寶	宝
將	將	将
專	專	专
尋	尋	寻
對	對	对
導	導	导
尷	尷	尴
屆	屆	届
屍	屍	尸
屓	屓	屃
屜	屜	屉
屢	屢	屡
層	層	层
屨	屨	屦
屩	屩	𪨗
屬	屬	属
岡	岡	冈
峯	峯	峰
峴	峴	岘
島	島	岛
峽	峽	峡
崍	崍	崃
崑	崑	昆
崗	崗	岗
崙	崙	仑 𪨧
崢	崢	峥
崬	崬	岽
嵐	嵐	岚
嵗	嵗	岁
嵼	嵼	𡶴
嵾	嵾	㟥
嶁	嶁	嵝
嶄	嶄	崭
嶇	嶇	岖
嶈	嶈	𡺃
嶔	嶔	嵚
嶗	嶗	崂
嶘	嶘	𡺄
嶠	嶠	峤
嶢	嶢	峣
嶧	嶧	峄
嶨	嶨	峃
嶮	嶮	崄
嶸	嶸	嵘
嶹	嶹	𫝵
嶺	嶺	岭
嶼	嶼	屿
嶽	嶽	岳
巊	巊	𪩎
巋	巋	岿
巒	巒	峦
巔	巔	巅
巖	巖	岩
巗	巗	𪨷
巘	巘	𪩘
巰	巰	巯
巹	巹	卺
帥	帥	帅
師	師	师
帳	帳	帐
帶	帶	带
幀	幀	帧
幃	幃	帏
幓	幓	㡎
幗	幗	帼
幘	幘	帻
幝	幝	𪩷
幟	幟	帜
幣	幣	币
幩	幩	𪩸
幫	幫	帮
幬	幬	帱
幹	幹	干
幾	幾	几
庫	庫	库
廁	廁	厕
廂	廂	厢
廄	廄	厩
廈	廈	厦
廎	廎	庼
廕	廕	荫
廚	廚	厨
廝	廝	厮
廟	廟	庙
廠	廠	厂
廡	廡	庑
廢	廢	废
廣	廣	广
廧	廧	𪪞
廩	廩	廪
廬	廬	庐 𪪏
廳	廳	厅
弒	弒	弑
弔	弔	吊
弳	弳	弪
張	張	张
強	強	强
彃	彃	𪪼
彆	彆	别
彈	彈	弹
彌	彌	弥
彎	彎	弯
彔	彔	录
彙	彙	汇
彠	彠	彟
彥	彥	彦
彫	彫	雕
彲	彲	彨
彷	彷	彷 仿
彿	彿	佛
後	後	后
徑	徑	径
從	從	从
徠	徠	徕
復	復	复
徵	徵	征 徵
徹	徹	彻
徿	徿	𪫌
恆	恆	恒
恥	恥	耻
悅	悅	悦
悞	悞	悮
悵	悵	怅
悶	悶	闷
悽	悽	凄
惡	惡	恶
惱	惱	恼
惲	惲	恽
惻	惻	恻
愛	愛	爱
愜	愜	惬
愨	愨	悫
愴	愴	怆
愷	愷	恺
愻	愻	𢙏
愾	愾	忾
慄	慄	栗
態	態	态
慍	慍	愠
慘	慘	惨
慚	慚	惭
慟	慟	恸
慣	慣	惯
慤	慤	悫
慪	慪	怄
慫	慫	怂
慮	慮	虑
慳	慳	悭
慶	慶	庆
慺	慺	㥪
慼	慼	戚
慾	慾	欲
憂	憂	忧
憊	憊	惫
憐	憐	怜
憑	憑	凭
憒	憒	愦
憖	憖	慭
憚	憚	惮
憢	憢	𢙒
憤	憤	愤
憫	憫	悯
憮	憮	怃
憲	憲	宪
憶	憶	忆
憸	憸	𪫺
憹	憹	𢙐
懀	懀	𢙓
懇	懇	恳
應	應	应
懌	懌	怿
懍	懍	懔
懎	懎	𢠁
懞	懞	蒙
懟	懟	怼
懣	懣	懑
懤	懤	㤽
懨	懨	恹
懲	懲	惩
懶	懶	懒
懷	懷	怀
懸	懸	悬
懺	懺	忏
懼	懼	惧
懾	懾	慑
戀	戀	恋
戇	戇	戆
戔	戔	戋
戧	戧	戗
戩	戩	戬
戰	戰	战 𢧐
戱	戱	戯
戲	戲	戏
戶	戶	户
拋	拋	抛
挩	挩	捝
挱	挱	挲
挾	挾	挟
捨	捨	舍
捫	捫	扪
捱	捱	挨
捲	捲	卷
掃	掃	扫
掄	掄	抡
掆	掆	㧏
掗	掗	挜
掙	掙	挣
掚	掚	𪭵
掛	掛	挂
採	採	采
揀	揀	拣
揚	揚	扬
換	換	换
揮	揮	挥
揯	揯	搄
損	損	损
搖	搖	摇
搗	搗	捣
搵	搵	揾
搶	搶	抢
摋	摋	𢫬
摐	摐	𪭢
摑	摑	掴
摜	摜	掼
摟	摟	搂
摯	摯	挚
摳	摳	抠
摶	摶	抟
摺	摺	折
摻	摻	掺
撈	撈	捞
撊	撊	𪭾
撏	撏	挦
撐	撐	撑
撓	撓	挠
撝	撝	㧑
撟	撟	挢
撣	撣	掸
撥	撥	拨
撧	撧	𪮖
撫	撫	抚
撲	撲	扑
撳	撳	揿
撻	撻	挞
撾	撾	挝
撿	撿	捡
擁	擁	拥
擄	擄	掳
擇	擇	择
擊	擊	击
擋	擋	挡
擓	擓	㧟
擔	擔	担
據	據	据
擟	擟	𪭧
擠	擠	挤
擣	擣	捣 𢭏
擫	擫	𢬍
擬	擬	拟
擯	擯	摈
擰	擰	拧
擱	擱	搁
擲	擲	掷
擴	擴	扩
擷	擷	撷
擺	擺	摆
擻	擻	擞
擼	擼	撸
擽	擽	㧰
擾	擾	扰
攄	攄	摅
攆	攆	撵
攋	攋	𪮶
攏	攏	拢
攔	攔	拦
攖	攖	撄
攙	攙	搀
攛	攛	撺
攜	攜	携
攝	攝	摄
攢	攢	攒
攣	攣	挛
攤	攤	摊
攪	攪	搅
攬	攬	揽
敎	敎	教
敓	敓	敚
敗	敗	败
敘	敘	叙
敵	敵	敌
數	數	数
斂	斂	敛
斃	斃	毙
斅	斅	𢽾
斆	斆	敩
斕	斕	斓
斬	斬	斩
斷	斷	断
斸	斸	𣃁
於	於	于 於
旂	旂	旗
旣	旣	既
昇	昇	升
時	時	时
晉	晉	晋
晝	晝	昼
暈	暈	晕
暉	暉	晖
暘	暘	旸
暢	暢	畅
暫	暫	暂
曄	曄	晔
曆	曆	历
曇	曇	昙
曉	曉	晓
曊	曊	𪰶
曏	曏	向
曖	曖	暧
曠	曠	旷
曥	曥	𣆐
曨	曨	昽
曬	曬	晒
書	書	书
會	會	会
朥	朥	𦛨
朧	朧	胧
朮	朮	术
東	東	东
枴	枴	拐
柵	柵	栅
柺	柺	拐
査	査	查
桱	桱	𣐕
桿	桿	杆
梔	梔	栀
梖	梖	𪱷
梘	梘	枧
條	條	条
梟	梟	枭
梲	梲	棁
棄	棄	弃
棊	棊	棋
棖	棖	枨
棗	棗	枣
棟	棟	栋
棡	棡	㭎
棧	棧	栈
棲	棲	栖
棶	棶	梾
椏	椏	桠
椲	椲	㭏
楇	楇	𣒌
楊	楊	杨
楓	楓	枫
楨	楨	桢
業	業	业
極	極	极
榘	榘	矩
榦	榦	干
榪	榪	杩
榮	榮	荣
榲	榲	榅
榿	榿	桤
構	構	构
槍	槍	枪
槓	槓	杠
槤	槤	梿
槧	槧	椠
槨	槨	椁
槫	槫	𣏢
槮	槮	椮
槳	槳	桨
槶	槶	椢
槼	槼	椝
樁	樁	桩
樂	樂	乐
樅	樅	枞
樑	樑	梁
樓	樓	楼
標	標	标
樞	樞	枢
樠	樠	𣗊
樢	樢	㭤
樣	樣	样
樤	樤	𣔌
樧	樧	榝
樫	樫	㭴
樳	樳	桪
樸	樸	朴
樹	樹	树
樺	樺	桦
樿	樿	椫
橈	橈	桡
橋	橋	桥
機	機	机
橢	橢	椭
橫	橫	横
橯	橯	𣓿
檁	檁	檩
檉	檉	柽
檔	檔	档
檜	檜	桧
檟	檟	槚
檢	檢	检
檣	檣	樯
檭	檭	𣘴
檮	檮	梼
檯	檯	台
檳	檳	槟
檵	檵	𪲛
檸	檸	柠
檻	檻	槛
櫃	櫃	柜
櫅	櫅	𪲎
櫓	櫓	橹
櫚	櫚	榈
櫛	櫛	栉
櫝	櫝	椟
櫞	櫞	橼
櫟	櫟	栎
櫠	櫠	𪲮
櫥	櫥	橱
櫧	櫧	槠
櫨	櫨	栌
櫪	櫪	枥
櫫	櫫	橥
櫬	櫬	榇
櫱	櫱	蘖
櫳	櫳	栊
櫸	櫸	榉
櫻	櫻	樱
欄	欄	栏
欅	欅	榉
欇	欇	𪳍
權	權	权
欍	欍	𣐤
欏	欏	椤
欐	欐	𪲔
欑	欑	𪴙
欒	欒	栾
欓	欓	𣗋
欖	欖	榄
欘	欘	𣚚
欞	欞	棂
欽	欽	钦
歎	歎	叹
歐	歐	欧
歟	歟	欤
歡	歡	欢
歲	歲	岁
歷	歷	历
歸	歸	归
歿	歿	殁
殘	殘	残
殞	殞	殒
殢	殢	𣨼
殤	殤	殇
殨	殨	㱮
殫	殫	殚
殭	殭	僵
殮	殮	殓
殯	殯	殡
殰	殰	㱩
殲	殲	歼
殺	殺	杀
殻	殻	壳
殼	殼	壳
毀	毀	毁
毆	毆	殴
毊	毊	𪵑
毿	毿	毵
氂	氂	牦
氈	氈	毡
氌	氌	氇
氣	氣	气
氫	氫	氢
氬	氬	氩
氭	氭	𣱝
氳	氳	氲
氾	氾	泛
汎	汎	泛
汙	汙	污
決	決	决
沒	沒	没
沖	沖	冲
況	況	况
泝	泝	溯
洩	洩	泄
洶	洶	汹
浹	浹	浃
涇	涇	泾
涗	涗	涚
涼	涼	凉
淒	淒	凄
淚	淚	泪
淥	淥	渌
淨	淨	净
淩	淩	凌
淪	淪	沦
淵	淵	渊
淶	淶	涞
淺	淺	浅
渙	渙	涣
減	減	减
渢	渢	沨
渦	渦	涡
測	測	测
渾	渾	浑
湊	湊	凑
湋	湋	𣲗
湞	湞	浈
湧	湧	涌
湯	湯	汤
溈	溈	沩
準	準	准
溝	溝	沟
溡	溡	𪶄
溫	溫	温
溮	溮	浉
溳	溳	涢
溼	溼	湿
滄	滄	沧
滅	滅	灭
滌	滌	涤
滎	滎	荥
滙	滙	汇
滬	滬	沪
滯	滯	滞
滲	滲	渗
滷	滷	卤
滸	滸	浒
滻	滻	浐
滾	滾	滚
滿	滿	满
漁	漁	渔
漊	漊	溇
漚	漚	沤
漢	漢	汉
漣	漣	涟
漬	漬	渍
漲	漲	涨
漵	漵	溆
漸	漸	渐
漿	漿	浆
潁	潁	颍
潑	潑	泼
潔	潔	洁
潕	潕	𣲘
潙	潙	沩
潚	潚	㴋
潛	潛	潜
潣	潣	𫞗
潤	潤	润
潯	潯	浔
潰	潰	溃
潷	潷	滗
潿	潿	涠
澀	澀	涩
澅	澅	𣶩
澆	澆	浇
澇	澇	涝
澐	澐	沄
澗	澗	涧
澠	澠	渑
澤	澤	泽
澦	澦	滪
澩	澩	泶
澬	澬	𫞚
澮	澮	浍
澱	澱	淀
澾	澾	㳠
濁	濁	浊
濃	濃	浓
濄	濄	㳡
濆	濆	𣸣
濕	濕	湿
濘	濘	泞
濚	濚	溁
濛	濛	蒙
濜	濜	浕
濟	濟	济
濤	濤	涛
濧	濧	㳔
濫	濫	滥
濰	濰	潍
濱	濱	滨
濺	濺	溅
濼	濼	泺
濾	濾	滤
濿	濿	𪵱
瀂	瀂	澛
瀃	瀃	𣽷
瀅	瀅	滢
瀆	瀆	渎
瀇	瀇	㲿
瀉	瀉	泻
瀋	瀋	沈 渖
瀏	瀏	浏
瀕	瀕	濒
瀘	瀘	泸
瀝	瀝	沥
瀟	瀟	潇
瀠	瀠	潆
瀦	瀦	潴
瀧	瀧	泷
瀨	瀨	濑
瀰	瀰	弥 㳽
瀲	瀲	潋
瀾	瀾	澜
灃	灃	沣
灄	灄	滠
灍	灍	𫞝
灑	灑	洒
灒	灒	𪷽
灕	灕	漓
灘	灘	滩
灙	灙	𣺼
灝	灝	灏
灡	灡	㳕
灣	灣	湾
灤	灤	滦
灧	灧	滟
灩	灩	滟
災	災	灾
為	為	为
烏	烏	乌
烴	烴	烃
無	無	无
煇	煇	𪸩
煉	煉	炼
煒	煒	炜
煙	煙	烟
煢	煢	茕
煥	煥	焕
煩	煩	烦
煬	煬	炀
煱	煱	㶽
熂	熂	𪸕
熅	熅	煴
熉	熉	𤈶
熌	熌	𤇄
熒	熒	荧
熓	熓	𤆡
熗	熗	炝
熚	熚	𤇹
熡	熡	𤋏
熱	熱	热
熲	熲	颎
熾	熾	炽
燁	燁	烨
燈	燈	灯
燉	燉	炖
燒	燒	烧
燙	燙	烫
燜	燜	焖
營	營	营
燦	燦	灿
燬	燬	毁
燭	燭	烛
燴	燴	烩
燶	燶	㶶
燻	燻	熏
燼	燼	烬
燾	燾	焘
爃	爃	𫞡
爄	爄	𤇃
爇	爇	𦶟
爍	爍	烁
爐	爐	炉
爖	爖	𤇭
爛	爛	烂
爥	爥	𪹳
爧	爧	𫞠
爭	爭	争
爲	爲	为
爺	爺	爷
爾	爾	尔
牀	牀	床
牆	牆	墙
牘	牘	牍
牴	牴	牴 抵
牽	牽	牵
犖	犖	荦
犛	犛	牦
犞	犞	𪺭
犢	犢	犊
犧	犧	牺
狀	狀	状
狹	狹	狭
狽	狽	狈
猌	猌	𪺽
猙	猙	狰
猶	猶	犹
猻	猻	狲
獁	獁	犸
獃	獃	呆
獄	獄	狱
獅	獅	狮
獊	獊	𪺷
獎	獎	奖
獨	獨	独
獩	獩	𤞃
獪	獪	狯
獫	獫	猃
獮	獮	狝
獰	獰	狞
獱	獱	㺍
獲	獲	获
獵	獵	猎
獷	獷	犷
獸	獸	兽
獺	獺	獭
獻	獻	献
獼	獼	猕
玀	玀	猡
玁	玁	𤞤
珼	珼	𫞥
現	現	现
琱	琱	雕
琺	琺	珐
琿	琿	珲
瑋	瑋	玮
瑒	瑒	玚
瑣	瑣	琐
瑤	瑤	瑶
瑩	瑩	莹
瑪	瑪	玛
瑲	瑲	玱
瑻	瑻	𪻲
瑽	瑽	𪻐
璉	璉	琏
璊	璊	𫞩
璝	璝	𪻺
璡	璡	琎
璣	璣	玑
璦	璦	瑷
璫	璫	珰
璯	璯	㻅
環	環	环
璵	璵	玙
璸	璸	瑸
璼	璼	𫞨
璽	璽	玺
璾	璾	𫞦
璿	璿	璇
瓄	瓄	𪻨
瓊	瓊	琼
瓏	瓏	珑
瓔	瓔	璎
瓕	瓕	𤦀
瓚	瓚	瓒
瓛	瓛	𤩽
甌	甌	瓯
甕	甕	瓮
產	產	产
産	産	产
甦	甦	苏
甯	甯	宁
畝	畝	亩
畢	畢	毕
畫	畫	画 划
異	異	异
畵	畵	画
當	當	当
畼	畼	𪽈
疇	疇	畴
疊	疊	叠
痙	痙	痉
痠	痠	酸
痮	痮	𪽪
痾	痾	疴
瘂	瘂	痖
瘋	瘋	疯
瘍	瘍	疡
瘓	瘓	痪
瘞	瘞	瘗
瘡	瘡	疮
瘧	瘧	疟
瘮	瘮	瘆
瘱	瘱	𪽷
瘲	瘲	疭
瘺	瘺	瘘
瘻	瘻	瘘
療	療	疗
癆	癆	痨
癇	癇	痫
癉	癉	瘅
癐	癐	𤶊
癒	癒	愈
癘	癘	疠
癟	癟	瘪
癡	癡	痴
癢	癢	痒
癤	癤	疖
癥	癥	症
癧	癧	疬
癩	癩	癞
癬	癬	癣
癭	癭	瘿
癮	癮	瘾
癰	癰	痈
癱	癱	瘫
癲	癲	癫
發	發	发
皁	皁	皂
皚	皚	皑
皟	皟	𤾀
皰	皰	疱
皸	皸	皲
皺	皺	皱
盃	盃	杯
盜	盜	盗
盞	盞	盏
盡	盡	尽
監	監	监
盤	盤	盘
盧	盧	卢
盨	盨	𪾔
盪	盪	荡
眝	眝	𪾣
眞	眞	真
眥	眥	眦
眾	眾	众
睍	睍	𪾢
睏	睏	困
睜	睜	睁
睞	睞	睐
瞘	瞘	眍
瞜	瞜	䁖
瞞	瞞	瞒
瞤	瞤	𥆧
瞭	瞭	瞭 了
瞶	瞶	瞆
瞼	瞼	睑
矇	矇	蒙
矉	矉	𪾸
矑	矑	𪾦
矓	矓	眬
矚	矚	瞩
矯	矯	矫
硃	硃	朱
硜	硜	硁
硤	硤	硖
硨	硨	砗
硯	硯	砚
碕	碕	埼
碙	碙	𥐻
碩	碩	硕
碭	碭	砀
碸	碸	砜
確	確	确
碼	碼	码
碽	碽	䂵
磑	磑	硙
磚	磚	砖
磠	磠	硵
磣	磣	碜
磧	磧	碛
磯	磯	矶
磽	磽	硗
磾	磾	䃅
礄	礄	硚
礆	礆	硷
礎	礎	础
礒	礒	𥐟
礙	礙	碍
礦	礦	矿
礪	礪	砺
礫	礫	砾
礬	礬	矾
礮	礮	𪿫
礱	礱	砻
祇	祇	祇 只
祕	祕	秘
祿	祿	禄
禍	禍	祸
禎	禎	祯
禕	禕	祎
禡	禡	祃
禦	禦	御
禪	禪	禅
禮	禮	礼
禰	禰	祢
禱	禱	祷
禿	禿	秃
秈	秈	籼
稅	稅	税
稈	稈	秆
稏	稏	䅉
稜	稜	棱
稟	稟	禀
種	種	种
稱	稱	称
穀	穀	谷
穇	穇	䅟
穌	穌	稣
積	積	积
穎	穎	颖
穠	穠	秾
穡	穡	穑
穢	穢	秽
穩	穩	稳
穫	穫	获
穭	穭	穞
窩	窩	窝
窪	窪	洼
窮	窮	穷
窯	窯	窑
窵	窵	窎
窶	窶	窭
窺	窺	窥
竄	竄	窜
竅	竅	窍
竇	竇	窦
竈	竈	灶
竊	竊	窃
竚	竚	𥩟
竪	竪	竖
竱	竱	𫁟
競	競	竞
筆	筆	笔
筍	筍	笋
筧	筧	笕
筴	筴	䇲
箇	箇	个
箋	箋	笺
箏	箏	筝
節	節	节
範	範	范
築	築	筑
篋	篋	箧
篔	篔	筼
篘	篘	𥬠
篠	篠	筿
篤	篤	笃
篩	篩	筛
篳	篳	筚
篸	篸	𥮾
簀	簀	箦
簂	簂	𫂆
簍	簍	篓
簑	簑	蓑
簞	簞	箪
簡	簡	简
簢	簢	𫂃
簣	簣	篑
簫	簫	箫
簹	簹	筜
簽	簽	签
簾	簾	帘
籃	籃	篮
籅	籅	𥫣
籋	籋	𥬞
籌	籌	筹
籔	籔	䉤
籙	籙	箓
籛	籛	篯
籜	籜	箨
籟	籟	籁
籠	籠	笼
籤	籤	签
籩	籩	笾
籪	籪	簖
籬	籬	篱
籮	籮	箩
籲	籲	吁
粵	粵	粤
糉	糉	粽
糝	糝	糁
糞	糞	粪
糧	糧	粮
糰	糰	团
糲	糲	粝
糴	糴	籴
糶	糶	粜
糹	糹	纟
糺	糺	𫄙
糾	糾	纠
紀	紀	纪
紂	紂	纣
約	約	约
紅	紅	红
紆	紆	纡
紇	紇	纥
紈	紈	纨
紉	紉	纫
紋	紋	纹
納	納	纳
紐	紐	纽
紓	紓	纾
純	純	纯
紕	紕	纰
紖	紖	纼
紗	紗	纱
紘	紘	纮
紙	紙	纸
級	級	级
紛	紛	纷
紜	紜	纭
紝	紝	纴
紟	紟	𫄛
紡	紡	纺
紬	紬	䌷
紮	紮	扎
細	細	细
紱	紱	绂
紲	紲	绁
紳	紳	绅
紵	紵	纻
紹	紹	绍
紺	紺	绀
紼	紼	绋
紿	紿	绐
絀	絀	绌
絁	絁	𫄟
終	終	终
絃	絃	弦
組	組	组
絅	絅	䌹
絆	絆	绊
絍	絍	𫟃
絎	絎	绗
結	結	结
絕	絕	绝
絙	絙	𫄠
絛	絛	绦
絝	絝	绔
絞	絞	绞
絡	絡	络
絢	絢	绚
絥	絥	𫄢
給	給	给
絧	絧	𫄡
絨	絨	绒
絰	絰	绖
統	統	统
絲	絲	丝
絳	絳	绛
絶	絶	绝
絹	絹	绢
絺	絺	𫄨
綀	綀	𦈌
綁	綁	绑
綃	綃	绡
綆	綆	绠
綇	綇	𦈋
綈	綈	绨
綉	綉	绣
綋	綋	𫟄
綌	綌	绤
綏	綏	绥
綐	綐	䌼
綑	綑	捆
經	經	经
綖	綖	𫄧
綜	綜	综
綞	綞	缍
綟	綟	𫄫
綠	綠	绿
綡	綡	𫟅
綢	綢	绸
綣	綣	绻
綫	綫	线
綬	綬	绶
維	維	维
綯	綯	绹
綰	綰	绾
綱	綱	纲
網	網	网
綳	綳	绷
綴	綴	缀
綵	綵	彩 䌽
綸	綸	纶
綹	綹	绺
綺	綺	绮
綻	綻	绽
綽	綽	绰
綾	綾	绫
綿	綿	绵
緄	緄	绲
緇	緇	缁
緊	緊	紧
緋	緋	绯
緍	緍	𦈏
緑	緑	绿
緒	緒	绪
緓	緓	绬
緔	緔	绱
緗	緗	缃
緘	緘	缄
緙	緙	缂
線	線	线 缐
緝	緝	缉
緞	緞	缎
緟	緟	𫟆
締	締	缔
緡	緡	缗
緣	緣	缘
緤	緤	𫄬
緦	緦	缌
編	編	编
緩	緩	缓
緬	緬	缅
緮	緮	𫄭
緯	緯	纬
緰	緰	𦈕
緱	緱	缑
緲	緲	缈
練	練	练
緶	緶	缏
緷	緷	𦈉
緸	緸	𦈑
緹	緹	缇
緻	緻	致
緼	緼	缊
縈	縈	萦
縉	縉	缙
縊	縊	缢
縋	縋	缒
縍	縍	𫄰
縎	縎	𦈔
縐	縐	绉
縑	縑	缣
縕	縕	缊
縗	縗	缞
縛	縛	缚
縝	縝	缜
縞	縞	缟
縟	縟	缛
縣	縣	县
縧	縧	绦
縫	縫	缝
縬	縬	𦈚
縭	縭	缡
縮	縮	缩
縰	縰	𫄳
縱	縱	纵
縲	縲	缧
縳	縳	䌸
縴	縴	纤
縵	縵	缦
縶	縶	絷
縷	縷	缕
縸	縸	𫄲
縹	縹	缥
縺	縺	𦈐
總	總	总
績	績	绩
繂	繂	𫄴
繃	繃	绷
繅	繅	缫
繆	繆	缪
繈	繈	𫄶
繏	繏	𦈝
繐	繐	𰬸
繒	繒	缯
繓	繓	𦈛
織	織	织
繕	繕	缮
繚	繚	缭
繞	繞	绕
繟	繟	𦈎
繡	繡	绣
繢	繢	缋
繨	繨	𫄤
繩	繩	绳
繪	繪	绘
繫	繫	系
繬	繬	𫄱
繭	繭	茧
繮	繮	缰
繯	繯	缳
繰	繰	缲
繳	繳	缴
繶	繶	𫄷
繷	繷	𫄣
繸	繸	䍁
繹	繹	绎
繻	繻	𦈡
繼	繼	继
繽	繽	缤
繾	繾	缱
繿	繿	䍀
纁	纁	𫄸
纇	纇	颣
纈	纈	缬
纊	纊	纩
續	續	续
纍	纍	累
纏	纏	缠
纓	纓	缨
纔	纔	才
纖	纖	纤
纗	纗	𫄹
纘	纘	缵
纚	纚	𫄥
纜	纜	缆
缽	缽	钵
罃	罃	䓨
罈	罈	坛
罌	罌	罂
罎	罎	坛
罰	罰	罚
罵	罵	骂
罷	罷	罢
羅	羅	罗
羆	羆	罴
羈	羈	羁
羋	羋	芈
羣	羣	群
羥	羥	羟
羨	羨	羡
義	義	义
羵	羵	𫅗
羶	羶	膻
習	習	习
翫	翫	玩
翬	翬	翚
翹	翹	翘
翽	翽	翙
耬	耬	耧
耮	耮	耢
聖	聖	圣
聞	聞	闻
聯	聯	联
聰	聰	聪
聲	聲	声
聳	聳	耸
聵	聵	聩
聶	聶	聂
職	職	职
聹	聹	聍
聻	聻	𫆏
聽	聽	听
聾	聾	聋
肅	肅	肃
脅	脅	胁
脈	脈	脉
脛	脛	胫
脣	脣	唇
脥	脥	𣍰
脩	脩	修
脫	脫	脱
脹	脹	胀
腎	腎	肾
腖	腖	胨
腡	腡	脶
腦	腦	脑
腪	腪	𣍯
腫	腫	肿
腳	腳	脚
腸	腸	肠
膃	膃	腽
膕	膕	腘
膚	膚	肤
膞	膞	䏝
膠	膠	胶
膢	膢	𦝼
膩	膩	腻
膹	膹	𪱥
膽	膽	胆
膾	膾	脍
膿	膿	脓
臉	臉	脸
臍	臍	脐
臏	臏	膑
臗	臗	𣎑
臘	臘	腊
臚	臚	胪
臟	臟	脏
臠	臠	脔
臢	臢	臜
臥	臥	卧
臨	臨	临
臺	臺	台
與	與	与
興	興	兴
舉	舉	举
舊	舊	旧
舘	舘	馆
艙	艙	舱
艣	艣	𫇛
艤	艤	舣
艦	艦	舰
艫	艫	舻
艱	艱	艰
艷	艷	艳
芻	芻	刍
苧	苧	苎
茲	茲	兹
荊	荊	荆
莊	莊	庄
莖	莖	茎
莢	莢	荚
莧	莧	苋
菕	菕	𰰨
華	華	华
菴	菴	庵
菸	菸	烟
萇	萇	苌
萊	萊	莱
萬	萬	万
萴	萴	荝
萵	萵	莴
葉	葉	叶
葒	葒	荭
葝	葝	𫈎
葤	葤	荮
葦	葦	苇
葯	葯	药
葷	葷	荤
蒍	蒍	𫇭
蒐	蒐	搜
蒓	蒓	莼
蒔	蒔	莳
蒕	蒕	蒀
蒞	蒞	莅
蒭	蒭	𫇴
蒼	蒼	苍
蓀	蓀	荪
蓆	蓆	席
蓋	蓋	盖
蓧	蓧	𦰏
蓮	蓮	莲
蓯	蓯	苁
蓴	蓴	莼
蓽	蓽	荜
蔔	蔔	卜
蔘	蔘	参
蔞	蔞	蒌
蔣	蔣	蒋
蔥	蔥	葱
蔦	蔦	茑
蔭	蔭	荫
蔯	蔯	𫈟
蔿	蔿	𫇭
蕁	蕁	荨
蕆	蕆	蒇
蕎	蕎	荞
蕒	蕒	荬
蕓	蕓	芸
蕕	蕕	莸
蕘	蕘	荛
蕝	蕝	𫈵
蕢	蕢	蒉
蕩	蕩	荡
蕪	蕪	芜
蕭	蕭	萧
蕳	蕳	𫈉
蕷	蕷	蓣
蕽	蕽	𫇽
薀	薀	蕰
薆	薆	𫉁
薈	薈	荟
薊	薊	蓟
薌	薌	芗
薑	薑	姜
薔	薔	蔷
薘	薘	荙
薟	薟	莶
薦	薦	荐
薩	薩	萨
薳	薳	䓕
薴	薴	苧
薵	薵	䓓
薹	薹	苔 薹
薺	薺	荠
藉	藉	藉 借
藍	藍	蓝
藎	藎	荩
藝	藝	艺
藥	藥	药
藪	藪	薮
藭	藭	䓖
藴	藴	蕴
藶	藶	苈
藷	藷	𫉄
藹	藹	蔼
藺	藺	蔺
蘀	蘀	萚
蘄	蘄	蕲
蘆	蘆	芦
蘇	蘇	苏
蘊	蘊	蕴
蘋	蘋	苹 蘋
蘚	蘚	藓
蘞	蘞	蔹
蘟	蘟	𦻕
蘢	蘢	茏
蘭	蘭	兰
蘺	蘺	蓠
蘿	蘿	萝
虆	虆	蔂
處	處	处
虛	虛	虚
虜	虜	虏
號	號	号
虧	虧	亏
虯	虯	虬
蛺	蛺	蛱
蛻	蛻	蜕
蜆	蜆	蚬
蝕	蝕	蚀
蝟	蝟	猬
蝦	蝦	虾
蝨	蝨	虱
蝸	蝸	蜗
螄	螄	蛳
螞	螞	蚂
螢	螢	萤
螮	螮	䗖
螻	螻	蝼
螿	螿	螀
蟂	蟂	𫋇
蟄	蟄	蛰
蟈	蟈	蝈
蟎	蟎	螨
蟘	蟘	𫋌
蟜	蟜	𫊸
蟣	蟣	虮
蟬	蟬	蝉
蟯	蟯	蛲
蟲	蟲	虫
蟳	蟳	𫊻
蟶	蟶	蛏
蟻	蟻	蚁
蠀	蠀	𧏗
蠁	蠁	蚃
蠅	蠅	蝇
蠆	蠆	虿
蠍	蠍	蝎
蠐	蠐	蛴
蠑	蠑	蝾
蠔	蠔	蚝
蠙	蠙	𧏖
蠟	蠟	蜡
蠣	蠣	蛎
蠦	蠦	𫊮
蠨	蠨	蟏
蠱	蠱	蛊
蠶	蠶	蚕
蠻	蠻	蛮
蠾	蠾	𧑏
衆	衆	众
衊	衊	蔑
術	術	术
衕	衕	同
衚	衚	胡
衛	衛	卫
衝	衝	冲
衹	衹	衹 只
袞	袞	衮
裊	裊	袅
裏	裏	里
補	補	补
裝	裝	装
裡	裡	里
製	製	制
複	複	复
褌	褌	裈
褘	褘	袆
褲	褲	裤
褳	褳	裢
褸	褸	褛
褻	褻	亵
襀	襀	𫌀
襇	襇	裥
襉	襉	裥
襏	襏	袯
襓	襓	𫋹
襖	襖	袄
襗	襗	𫋷
襘	襘	𫋻
襝	襝	裣
襠	襠	裆
襤	襤	褴
襪	襪	袜
襬	襬	摆 䙓
襯	襯	衬
襰	襰	𧝝
襲	襲	袭
襴	襴	襕
襵	襵	𫌇
覆	覆	覆 复
覈	覈	核
見	見	见
覎	覎	觃
規	規	规
覓	覓	觅
視	視	视
覘	覘	觇
覛	覛	𫌪
覡	覡	觋
覥	覥	觍
覦	覦	觎
親	親	亲
覬	覬	觊
覯	覯	觏
覲	覲	觐
覷	覷	觑
覹	覹	𫌭
覺	覺	觉
覼	覼	𫌨
覽	覽	览
覿	覿	觌
觀	觀	观
觴	觴	觞
觶	觶	觯
觸	觸	触
訁	訁	讠
訂	訂	订
訃	訃	讣
計	計	计
訊	訊	讯
訌	訌	讧
討	討	讨
訐	訐	讦
訑	訑	𫍙
訒	訒	讱
訓	訓	训
訕	訕	讪
訖	訖	讫
託	託	托 讬
記	記	记
訛	訛	讹
訜	訜	𫍛
訝	訝	讶
訞	訞	𫍚
訟	訟	讼
訢	訢	䜣
訣	訣	诀
訥	訥	讷
訨	訨	𫟞
訩	訩	讻
訪	訪	访
設	設	设
許	許	许
訴	訴	诉
訶	訶	诃
診	診	诊
註	註	注
証	証	证
詀	詀	𧮪
詁	詁	诂
詆	詆	诋
詊	詊	𫟟
詎	詎	讵
詐	詐	诈
詑	詑	𫍡
詒	詒	诒
詓	詓	𫍜
詔	詔	诏
評	評	评
詖	詖	诐
詗	詗	诇
詘	詘	诎
詛	詛	诅
詞	詞	词
詠	詠	咏
詡	詡	诩
詢	詢	询
詣	詣	诣
試	試	试
詩	詩	诗
詫	詫	诧
詬	詬	诟
詭	詭	诡
詮	詮	诠
詰	詰	诘
話	話	话
該	該	该
詳	詳	详
詵	詵	诜
詷	詷	𫍣
詼	詼	诙
詿	詿	诖
誂	誂	𫍥
誄	誄	诔
誅	誅	诛
誆	誆	诓
誇	誇	夸
誋	誋	𫍪
誌	誌	志
認	認	认
誑	誑	诳
誒	誒	诶
誕	誕	诞
誘	誘	诱
誚	誚	诮
語	語	语
誠	誠	诚
誡	誡	诫
誣	誣	诬
誤	誤	误
誥	誥	诰
誦	誦	诵
誨	誨	诲
說	說	说
誫	誫	𫍨
説	説	说
誰	誰	谁
課	課	课
誳	誳	𫍮
誴	誴	𫟡
誶	誶	谇
誷	誷	𫍬
誹	誹	诽
誺	誺	𫍧
誼	誼	谊
誾	誾	訚
調	調	调
諂	諂	谄
諄	諄	谆
談	談	谈
諉	諉	诿
請	請	请
諍	諍	诤
諏	諏	诹
諑	諑	诼
諒	諒	谅
論	論	论
諗	諗	谂
諛	諛	谀
諜	諜	谍
諝	諝	谞
諞	諞	谝
諡	諡	谥
諢	諢	诨
諣	諣	𫍩
諤	諤	谔
諥	諥	𫍳
諦	諦	谛
諧	諧	谐
諫	諫	谏 𫍝
諭	諭	谕
諮	諮	咨 谘
諯	諯	𫍱
諰	諰	𫍰
諱	諱	讳
諳	諳	谙
諴	諴	𫍯
諶	諶	谌
諷	諷	讽
諸	諸	诸
諺	諺	谚
諼	諼	谖
諾	諾	诺
謀	謀	谋
謁	謁	谒
謂	謂	谓
謄	謄	誊
謅	謅	诌
謆	謆	𫍸
謉	謉	𫍷
謊	謊	谎
謎	謎	谜
謏	謏	𫍲
謐	謐	谧
謔	謔	谑
謖	謖	谡
謗	謗	谤
謙	謙	谦
謚	謚	谥
講	講	讲
謝	謝	谢
謠	謠	谣
謡	謡	谣
謨	謨	谟
謫	謫	谪
謬	謬	谬
謭	謭	谫
謯	謯	𫍹
謱	謱	𫍴
謳	謳	讴
謸	謸	𫍵
謹	謹	谨
謾	謾	谩
譁	譁	哗
譂	譂	𫟠
譅	譅	𰶎
譆	譆	𫍻
證	證	证
譊	譊	𫍢
譎	譎	谲
譏	譏	讥
譑	譑	𫍤
譖	譖	谮
識	識	识
譙	譙	谯
譚	譚	谭
譜	譜	谱
譞	譞	𫍽
譟	譟	噪
譨	譨	𫍦
譫	譫	谵
譭	譭	毁
譯	譯	译
議	議	议
譴	譴	谴
護	護	护
譸	譸	诪
譽	譽	誉
譾	譾	谫 𫍿
讀	讀	读
讅	讅	谉
變	變	变
讋	讋	詟
讌	讌	䜩
讎	讎	雠
讒	讒	谗
讓	讓	让
讕	讕	谰
讖	讖	谶
讚	讚	赞
讜	讜	谠
讞	讞	谳
豈	豈	岂
豎	豎	竖
豐	豐	丰
豔	豔	艳
豬	豬	猪
豵	豵	𫎆
豶	豶	豮
貓	貓	猫
貗	貗	𫎌
貙	貙	䝙
貝	貝	贝
貞	貞	贞
貟	貟	贠
負	負	负
財	財	财
貢	貢	贡
貧	貧	贫
貨	貨	货
販	販	贩
貪	貪	贪
貫	貫	贯
責	責	责
貯	貯	贮
貰	貰	贳
貲	貲	赀
貳	貳	贰
貴	貴	贵
貶	貶	贬
買	買	买 𧹒
貸	貸	贷
貺	貺	贶
費	費	费
貼	貼	贴
貽	貽	贻
貿	貿	贸
賀	賀	贺
賁	賁	贲
賂	賂	赂
賃	賃	赁
賄	賄	贿
賅	賅	赅
資	資	资
賈	賈	贾
賊	賊	贼
賑	賑	赈
賒	賒	赊
賓	賓	宾
賕	賕	赇
賙	賙	赒
賚	賚	赉
賜	賜	赐
賝	賝	𫎩
賞	賞	赏
賟	賟	𧹖
賠	賠	赔
賡	賡	赓
賢	賢	贤
賣	賣	卖
賤	賤	贱
賦	賦	赋
賧	賧	赕
質	質	质
賫	賫	赍
賬	賬	账
賭	賭	赌
賰	賰	䞐
賴	賴	赖
賵	賵	赗
賺	賺	赚
賻	賻	赙
購	購	购
賽	賽	赛
賾	賾	赜
贃	贃	𧹗
贄	贄	贽
贅	贅	赘
贇	贇	赟
贈	贈	赠
贉	贉	𫎫
贊	贊	赞
贋	贋	赝
贍	贍	赡
贏	贏	赢
贐	贐	赆
贑	贑	𫎬
贓	贓	赃
贔	贔	赑
贖	贖	赎
贗	贗	赝
贚	贚	𫎦
贛	贛	赣
贜	贜	赃
赬	赬	赪
趕	趕	赶
趙	趙	赵
趨	趨	趋
趲	趲	趱
跡	跡	迹
踐	踐	践
踰	踰	逾
踴	踴	踊
蹌	蹌	跄
蹔	蹔	𫏐
蹕	蹕	跸
蹟	蹟	迹
蹠	蹠	跖
蹣	蹣	蹒
蹤	蹤	踪
蹳	蹳	𫏆
蹺	蹺	跷
蹻	蹻	𫏋
躂	躂	跶
躉	躉	趸
躊	躊	踌
躋	躋	跻
躍	躍	跃
躎	躎	䟢
躑	躑	踯
躒	躒	跞
躓	躓	踬
躕	躕	蹰
躘	躘	𨀁
躚	躚	跹
躝	躝	𨅬
躡	躡	蹑
躥	躥	蹿
躦	躦	躜
躪	躪	躏
軀	軀	躯
軉	軉	𨉗
車	車	车
軋	軋	轧
軌	軌	轨
軍	軍	军
軏	軏	𫐄
軑	軑	轪
軒	軒	轩
軔	軔	轫
軕	軕	𫐅
軗	軗	𨐅
軛	軛	轭
軜	軜	𫐇
軟	軟	软
軤	軤	轷
軨	軨	𫐉
軫	軫	轸
軬	軬	𫐊
軲	軲	轱
軷	軷	𫐈
軸	軸	轴
軹	軹	轵
軺	軺	轺
軻	軻	轲
軼	軼	轶
軾	軾	轼
軿	軿	𫐌
較	較	较
輄	輄	𨐈
輅	輅	辂
輇	輇	辁
輈	輈	辀
載	載	载
輊	輊	轾
輋	輋	𪨶
輒	輒	辄
輓	輓	挽
輔	輔	辅
輕	輕	轻
輖	輖	𫐏
輗	輗	𫐐
輛	輛	辆
輜	輜	辎
輝	輝	辉
輞	輞	辋
輟	輟	辍
輢	輢	𫐎
輥	輥	辊
輦	輦	辇
輨	輨	𫐑
輩	輩	辈
輪	輪	轮
輬	輬	辌
輮	輮	𫐓
輯	輯	辑
輳	輳	辏
輷	輷	𫐒
輸	輸	输
輻	輻	辐
輼	輼	辒
輾	輾	辗
輿	輿	舆
轀	轀	辒
轂	轂	毂
轄	轄	辖
轅	轅	辕
轆	轆	辘
轇	轇	𫐖
轉	轉	转
轊	轊	𫐕
轍	轍	辙
轎	轎	轿
轐	轐	𫐗
轔	轔	辚
轗	轗	𫐘
轟	轟	轰
轠	轠	𫐙
轡	轡	辔
轢	轢	轹
轣	轣	𫐆
轤	轤	轳
辦	辦	办
辭	辭	辞
辮	辮	辫
辯	辯	辩
農	農	农
迴	迴	回
逕	逕	迳
這	這	这
連	連	连
週	週	周
進	進	进
遊	遊	游
運	運	运
過	過	过
達	達	达
違	違	违
遙	遙	遥
遜	遜	逊
遞	遞	递
遠	遠	远
遡	遡	溯
適	適	适
遱	遱	𫐷
遲	遲	迟
遷	遷	迁
選	選	选
遺	遺	遗
遼	遼	辽
邁	邁	迈
還	還	还
邇	邇	迩
邊	邊	边
邏	邏	逻
邐	邐	逦
郟	郟	郏
郵	郵	邮
鄆	鄆	郓
鄉	鄉	乡
鄒	鄒	邹
鄔	鄔	邬
鄖	鄖	郧
鄟	鄟	𫑘
鄧	鄧	邓
鄭	鄭	郑
鄰	鄰	邻
鄲	鄲	郸
鄳	鄳	𫑡
鄴	鄴	邺
鄶	鄶	郐
鄺	鄺	邝
酇	酇	酂
酈	酈	郦
醃	醃	腌
醖	醖	酝
醜	醜	丑
醞	醞	酝
醟	醟	蒏
醣	醣	糖
醫	醫	医
醬	醬	酱
醱	醱	酦
醶	醶	𫑷
釀	釀	酿
釁	釁	衅
釃	釃	酾
釅	釅	酽
釋	釋	释
釐	釐	厘
釒	釒	钅
釓	釓	钆
釔	釔	钇
釕	釕	钌
釗	釗	钊
釘	釘	钉
釙	釙	钋
釚	釚	𫟲
針	針	针
釟	釟	𫓥
釣	釣	钓
釤	釤	钐
釦	釦	扣
釧	釧	钏
釨	釨	𫓦
釩	釩	钒
釲	釲	𫟳
釳	釳	𨰿
釵	釵	钗
釷	釷	钍
釹	釹	钕
釺	釺	钎
釾	釾	䥺
鈀	鈀	钯
鈁	鈁	钫
鈃	鈃	钘
鈄	鈄	钭
鈅	鈅	钥
鈆	鈆	𫓪
鈇	鈇	𫓧
鈈	鈈	钚
鈉	鈉	钠
鈋	鈋	𨱂
鈍	鈍	钝
鈎	鈎	钩
鈐	鈐	钤
鈑	鈑	钣
鈒	鈒	钑
鈔	鈔	钞
鈕	鈕	钮
鈖	鈖	𫟴
鈗	鈗	𫟵
鈛	鈛	𫓨
鈞	鈞	钧
鈠	鈠	𨱁
鈡	鈡	钟
鈣	鈣	钙
鈥	鈥	钬
鈦	鈦	钛
鈧	鈧	钪
鈮	鈮	铌
鈯	鈯	𨱄
鈰	鈰	铈
鈲	鈲	𨱃
鈳	鈳	钶
鈴	鈴	铃
鈷	鈷	钴
鈸	鈸	钹
鈹	鈹	铍
鈺	鈺	钰
鈽	鈽	钸
鈾	鈾	铀
鈿	鈿	钿
鉀	鉀	钾
鉁	鉁	𨱅
鉅	鉅	巨 钜
鉆	鉆	钻
鉈	鉈	铊
鉉	鉉	铉
鉋	鉋	铇
鉍	鉍	铋
鉑	鉑	铂
鉔	鉔	𫓬
鉕	鉕	钷
鉗	鉗	钳
鉚	鉚	铆
鉛	鉛	铅
鉝	鉝	𫟷
鉞	鉞	钺
鉠	鉠	𫓭
鉢	鉢	钵
鉤	鉤	钩
鉦	鉦	钲
鉬	鉬	钼
鉭	鉭	钽
鉳	鉳	锫
鉶	鉶	铏
鉷	鉷	𫟹
鉸	鉸	铰
鉺	鉺	铒
鉻	鉻	铬
鉽	鉽	𫟸
鉾	鉾	𫓴
鉿	鉿	铪
銀	銀	银
銁	銁	𫓲
銂	銂	𫟻
銃	銃	铳
銅	銅	铜
銈	銈	𫓯
銊	銊	𫓰
銍	銍	铚
銏	銏	𫟶
銑	銑	铣
銓	銓	铨
銖	銖	铢
銘	銘	铭
銚	銚	铫
銛	銛	铦
銜	銜	衔
銠	銠	铑
銣	銣	铷
銥	銥	铱
銦	銦	铟
銨	銨	铵
銩	銩	铥
銪	銪	铕
銫	銫	铯
銬	銬	铐
銱	銱	铞
銳	銳	锐
銶	銶	𨱇
銷	銷	销
銹	銹	锈
銻	銻	锑
銼	銼	锉
鋁	鋁	铝
鋂	鋂	𰾄
鋃	鋃	锒
鋅	鋅	锌
鋇	鋇	钡
鋉	鋉	𨱈
鋌	鋌	铤
鋏	鋏	铗
鋒	鋒	锋
鋗	鋗	𫓶
鋙	鋙	铻
鋝	鋝	锊
鋟	鋟	锓
鋠	鋠	𫓵
鋣	鋣	铘
鋤	鋤	锄
鋥	鋥	锃
鋦	鋦	锔
鋨	鋨	锇
鋩	鋩	铓
鋪	鋪	铺
鋭	鋭	锐
鋮	鋮	铖
鋯	鋯	锆
鋰	鋰	锂
鋱	鋱	铽
鋶	鋶	锍
鋸	鋸	锯
鋼	鋼	钢
錀	錀	𬬭
錁	錁	锞
錂	錂	𨱋
錄	錄	录
錆	錆	锖
錇	錇	锫
錈	錈	锩
錏	錏	铔
錐	錐	锥
錒	錒	锕
錕	錕	锟
錘	錘	锤
錙	錙	锱
錚	錚	铮
錛	錛	锛
錜	錜	𫓻
錝	錝	𫓽
錟	錟	锬
錠	錠	锭
錡	錡	锜
錢	錢	钱
錤	錤	𫓹
錥	錥	𫓾
錦	錦	锦
錨	錨	锚
錩	錩	锠
錫	錫	锡
錮	錮	锢
錯	錯	错
録	録	录
錳	錳	锰
錶	錶	表
錸	錸	铼
錼	錼	镎
錽	錽	𫓸
鍀	鍀	锝
鍁	鍁	锨
鍃	鍃	锪
鍄	鍄	𨱉
鍅	鍅	钫
鍆	鍆	钔
鍇	鍇	锴
鍈	鍈	锳
鍉	鍉	𫔂
鍊	鍊	炼 链 𫔀
鍋	鍋	锅
鍍	鍍	镀
鍒	鍒	𫔄
鍔	鍔	锷
鍘	鍘	铡
鍚	鍚	钖
鍛	鍛	锻
鍠	鍠	锽
鍤	鍤	锸
鍥	鍥	锲
鍩	鍩	锘
鍬	鍬	锹
鍮	鍮	𨱎
鍰	鍰	锾
鍵	鍵	键
鍶	鍶	锶
鍺	鍺	锗
鍼	鍼	针
鍾	鍾	钟 锺
鎂	鎂	镁
鎄	鎄	锿
鎇	鎇	镅
鎈	鎈	𫟿
鎊	鎊	镑
鎌	鎌	镰
鎍	鎍	𫔅
鎔	鎔	镕
鎖	鎖	锁
鎘	鎘	镉
鎙	鎙	𫔈
鎚	鎚	锤
鎛	鎛	镈
鎝	鎝	𨱏
鎞	鎞	𫔇
鎡	鎡	镃
鎢	鎢	钨
鎣	鎣	蓥
鎦	鎦	镏
鎧	鎧	铠
鎩	鎩	铩
鎪	鎪	锼
鎬	鎬	镐
鎭	鎭	镇
鎮	鎮	镇
鎯	鎯	𨱍
鎰	鎰	镒
鎲	鎲	镋
鎳	鎳	镍
鎵	鎵	镓
鎶	鎶	鿔
鎷	鎷	𨰾
鎸	鎸	镌
鎿	鎿	镎
鏃	鏃	镞
鏆	鏆	𨱌
鏇	鏇	旋 镟
鏈	鏈	链
鏉	鏉	𨱒
鏌	鏌	镆
鏍	鏍	镙
鏐	鏐	镠
鏑	鏑	镝
鏗	鏗	铿
鏘	鏘	锵
鏚	鏚	𬭭
鏜	鏜	镗
鏝	鏝	镘
鏞	鏞	镛
鏟	鏟	铲
鏡	鏡	镜
鏢	鏢	镖
鏤	鏤	镂
鏥	鏥	𫔊
鏦	鏦	𫓩
鏨	鏨	錾
鏰	鏰	镚
鏵	鏵	铧
鏷	鏷	镤
鏹	鏹	镪
鏺	鏺	䥽
鏽	鏽	锈
鏾	鏾	𫔌
鐃	鐃	铙
鐄	鐄	𨱑
鐇	鐇	𫔍
鐈	鐈	𫓱
鐋	鐋	铴
鐍	鐍	𫔎
鐎	鐎	𨱓
鐏	鐏	𨱔
鐐	鐐	镣
鐒	鐒	铹
鐓	鐓	镦
鐔	鐔	镡
鐘	鐘	钟
鐙	鐙	镫
鐝	鐝	镢
鐠	鐠	镨
鐥	鐥	䦅
鐦	鐦	锎
鐧	鐧	锏
鐨	鐨	镄
鐪	鐪	𫓺
鐫	鐫	镌
鐮	鐮	镰
鐯	鐯	䦃
鐲	鐲	镯
鐳	鐳	镭
鐵	鐵	铁
鐶	鐶	镮
鐸	鐸	铎
鐺	鐺	铛
鐼	鐼	𫔁
鐽	鐽	𫟼
鐿	鐿	镱
鑀	鑀	𰾭
鑄	鑄	铸
鑉	鑉	𫠁
鑊	鑊	镬
鑌	鑌	镔
鑑	鑑	鉴
鑒	鑒	鉴
鑔	鑔	镲
鑕	鑕	锧
鑞	鑞	镴
鑠	鑠	铄
鑣	鑣	镳
鑥	鑥	镥
鑪	鑪	𬬻
鑭	鑭	镧
鑰	鑰	钥
鑱	鑱	镵
鑲	鑲	镶
鑴	鑴	𫔔
鑷	鑷	镊
鑹	鑹	镩
鑼	鑼	锣
鑽	鑽	钻
鑾	鑾	銮
鑿	鑿	凿
钁	钁	镢 䦆
钂	钂	镋
長	長	长
門	門	门
閂	閂	闩
閃	閃	闪
閆	閆	闫
閈	閈	闬
閉	閉	闭
開	開	开 𫔭
閌	閌	闶
閍	閍	𨸂
閎	閎	闳
閏	閏	闰
閐	閐	𨸃
閑	閑	闲
閒	閒	闲 𫔮
間	間	间
閔	閔	闵
閗	閗	𫔯
閘	閘	闸
閝	閝	𫠂
閞	閞	𫔰
閡	閡	阂
閣	閣	阁
閤	閤	合
閥	閥	阀
閨	閨	闺
閩	閩	闽
閫	閫	阃
閬	閬	阆
閭	閭	闾
閱	閱	阅
閲	閲	阅
閵	閵	𫔴
閶	閶	阊
閹	閹	阉
閻	閻	阎
閼	閼	阏
閽	閽	阍
閾	閾	阈
閿	閿	阌
闃	闃	阒
闆	闆	板
闇	闇	暗
闈	闈	闱
闊	闊	阔
闋	闋	阕
闌	闌	阑
闍	闍	阇
闐	闐	阗
闑	闑	𫔶
闒	闒	阘
闓	闓	闿
闔	闔	阖
闕	闕	阙
闖	闖	闯
關	關	关
闞	闞	阚
闠	闠	阓
闡	闡	阐
闢	闢	辟
闤	闤	阛
闥	闥	闼
阪	阪	阪 坂
陘	陘	陉
陝	陝	陕
陞	陞	升
陣	陣	阵
陰	陰	阴
陳	陳	陈
陸	陸	陆
陽	陽	阳
隉	隉	陧
隊	隊	队
階	階	阶
隕	隕	陨
際	際	际
隨	隨	随
險	險	险
隯	隯	陦
隱	隱	隐
隴	隴	陇
隸	隸	隶
隻	隻	只
雋	雋	隽
雖	雖	虽
雙	雙	双
雛	雛	雏
雜	雜	杂
雞	雞	鸡
離	離	离
難	難	难
雲	雲	云
電	電	电
霑	霑	沾
霢	霢	霡
霣	霣	𫕥
霧	霧	雾
霼	霼	𪵣
霽	霽	霁
靂	靂	雳
靄	靄	霭
靆	靆	叇
靈	靈	灵
靉	靉	叆
靚	靚	靓
靜	靜	静
靝	靝	靔
靦	靦	腼 䩄
靧	靧	𫖃
靨	靨	靥
鞏	鞏	巩
鞝	鞝	绱
鞦	鞦	秋
鞽	鞽	鞒
鞾	鞾	𫖇
韁	韁	缰
韃	韃	鞑
韆	韆	千
韉	韉	鞯
韋	韋	韦
韌	韌	韧
韍	韍	韨
韓	韓	韩
韙	韙	韪
韚	韚	𫠅
韛	韛	𫖔
韜	韜	韬
韝	韝	鞲 𫖕
韞	韞	韫
韠	韠	𫖒
韻	韻	韵
響	響	响
頁	頁	页
頂	頂	顶
頃	頃	顷
項	項	项
順	順	顺
頇	頇	顸
須	須	须
頊	頊	顼
頌	頌	颂
頍	頍	𫠆
頎	頎	颀
頏	頏	颃
預	預	预
頑	頑	顽
頒	頒	颁
頓	頓	顿
頗	頗	颇
領	領	领
頜	頜	颌
頡	頡	颉
頤	頤	颐
頦	頦	颏
頫	頫	𫖯
頭	頭	头
頮	頮	颒
頰	頰	颊
頲	頲	颋
頴	頴	颕
頵	頵	𫖳
頷	頷	颔
頸	頸	颈
頹	頹	颓
頻	頻	频
頽	頽	颓
顂	顂	𩓋
顃	顃	𩖖
顅	顅	𫖶
顆	顆	颗
題	題	题
額	額	额
顎	顎	颚
顏	顏	颜
顒	顒	颙
顓	顓	颛
顔	顔	颜
顗	顗	𫖮
願	願	愿 𫖸
顙	顙	颡
顛	顛	颠
類	類	类
顢	顢	颟
顣	顣	𫖹
顥	顥	颢
顧	顧	顾
顫	顫	颤
顬	顬	颥
顯	顯	显
顰	顰	颦
顱	顱	颅
顳	顳	颞
顴	顴	颧
風	風	风
颭	颭	飐
颮	颮	飑
颯	颯	飒
颰	颰	𩙥
颱	颱	台
颳	颳	刮
颶	颶	飓
颷	颷	𩙪
颸	颸	飔
颺	颺	飏
颻	颻	飖
颼	颼	飕
颾	颾	𩙫
飀	飀	飗
飄	飄	飘
飆	飆	飙
飈	飈	飚
飋	飋	𫗋
飛	飛	飞
飠	飠	饣
飢	飢	饥
飣	飣	饤
飥	飥	饦
飦	飦	𫗞
飩	飩	饨
飪	飪	饪
飫	飫	饫
飭	飭	饬
飯	飯	饭
飱	飱	飧
飲	飲	饮
飴	飴	饴
飵	飵	𫗢
飶	飶	𫗣
飼	飼	饲
飽	飽	饱
飾	飾	饰
飿	飿	饳
餃	餃	饺
餄	餄	饸
餅	餅	饼
餈	餈	糍
餉	餉	饷
養	養	养
餌	餌	饵
餎	餎	饹
餏	餏	饻
餑	餑	饽
餒	餒	馁
餓	餓	饿
餔	餔	𫗦
餕	餕	馂
餖	餖	饾
餗	餗	𫗧
餘	餘	余 馀
餚	餚	肴
餛	餛	馄
餜	餜	馃
餞	餞	饯
餡	餡	馅
餦	餦	𫗠
餧	餧	𫗪
館	館	馆
餪	餪	𫗬
餫	餫	𫗥
餬	餬	糊 𫗫
餭	餭	𫗮
餱	餱	糇 𫗯
餳	餳	饧
餵	餵	喂 𫗭
餶	餶	馉
餷	餷	馇
餸	餸	𩠌
餺	餺	馎
餼	餼	饩
餾	餾	馏
餿	餿	馊
饁	饁	馌
饃	饃	馍
饅	饅	馒
饈	饈	馐
饉	饉	馑
饊	饊	馓
饋	饋	馈
饌	饌	馔
饑	饑	饥
饒	饒	饶
饗	饗	飨
饘	饘	𫗴
饜	饜	餍
饞	饞	馋
饟	饟	𫗵
饠	饠	𫗩
饢	饢	馕
馬	馬	马
馭	馭	驭
馮	馮	冯
馯	馯	𫘛
馱	馱	驮
馳	馳	驰
馴	馴	驯
馹	馹	驲
馼	馼	𫘜
駁	駁	驳
駃	駃	𫘝
駊	駊	𫘟
駎	駎	𩧨
駐	駐	驻
駑	駑	驽
駒	駒	驹
駔	駔	驵
駕	駕	驾
駘	駘	骀
駙	駙	驸
駚	駚	𩧫
駛	駛	驶
駝	駝	驼
駞	駞	𫘞
駟	駟	驷
駡	駡	骂
駢	駢	骈
駤	駤	𫘠
駧	駧	𩧲
駩	駩	𩧴
駫	駫	𫘡
駭	駭	骇
駰	駰	骃
駱	駱	骆
駶	駶	𩧺
駸	駸	骎
駻	駻	𫘣
駿	駿	骏
騁	騁	骋
騂	騂	骍
騃	騃	𫘤
騄	騄	𫘧
騅	騅	骓
騉	騉	𫘥
騊	騊	𫘦
騌	騌	骔
騍	騍	骒
騎	騎	骑
騏	騏	骐
騔	騔	𩨀
騖	騖	骛
騙	騙	骗
騚	騚	𩨊
騜	騜	𫘩
騝	騝	𩨃
騟	騟	𩨈
騠	騠	𫘨
騤	騤	骙
騧	騧	䯄
騪	騪	𩨄
騫	騫	骞
騭	騭	骘
騮	騮	骝
騰	騰	腾
騱	騱	𫘬
騴	騴	𫘫
騵	騵	𫘪
騶	騶	驺
騷	騷	骚
騸	騸	骟
騻	騻	𫘭
騼	騼	𫠋
騾	騾	骡
驀	驀	蓦
驁	驁	骜
驂	驂	骖
驃	驃	骠
驄	驄	骢 𩨂
驅	驅	驱
驊	驊	骅
驋	驋	𩧯
驌	驌	骕
驍	驍	骁
驏	驏	骣
驓	驓	𫘯
驕	驕	骄
驗	驗	验
驙	驙	𫘰
驚	驚	惊
驛	驛	驿
驟	驟	骤
驢	驢	驴
驤	驤	骧
驥	驥	骥
驦	驦	骦
驨	驨	𫘱
驪	驪	骊
驫	驫	骉
骯	骯	肮
髏	髏	髅
髒	髒	脏
體	體	体
髕	髕	髌
髖	髖	髋
髮	髮	发
鬆	鬆	松
鬍	鬍	胡
鬖	鬖	𩭹
鬚	鬚	须
鬠	鬠	𫘽
鬢	鬢	鬓
鬥	鬥	斗
鬧	鬧	闹
鬨	鬨	哄
鬩	鬩	阋
鬮	鬮	阄
鬱	鬱	郁
鬹	鬹	鬶
魎	魎	魉
魘	魘	魇
魚	魚	鱼
魛	魛	鱽
魟	魟	𫚉
魢	魢	鱾
魥	魥	𩽹
魦	魦	𫚌
魨	魨	鲀
魯	魯	鲁
魴	魴	鲂
魵	魵	𫚍
魷	魷	鱿
魺	魺	鲄
魽	魽	𫠐
鮁	鮁	鲅
鮃	鮃	鲆
鮄	鮄	𫚒
鮅	鮅	𫚑
鮆	鮆	𫚖
鮊	鮊	鲌
鮋	鮋	鲉
鮍	鮍	鲏
鮎	鮎	鲇
鮐	鮐	鲐
鮑	鮑	鲍
鮒	鮒	鲋
鮓	鮓	鲊
鮚	鮚	鲒
鮜	鮜	鲘
鮝	鮝	鲞
鮞	鮞	鲕
鮟	鮟	𩽾
鮣	鮣	䲟
鮤	鮤	𫚓
鮦	鮦	鲖
鮪	鮪	鲔
鮫	鮫	鲛
鮭	鮭	鲑
鮮	鮮	鲜
鮯	鮯	𫚗
鮰	鮰	𫚔
鮳	鮳	鲓
鮵	鮵	𫚛
鮶	鮶	鲪
鮸	鮸	𩾃
鮺	鮺	鲝
鮿	鮿	𫚚
鯀	鯀	鲧
鯁	鯁	鲠
鯄	鯄	𩾁
鯆	鯆	𫚙
鯇	鯇	鲩
鯉	鯉	鲤
鯊	鯊	鲨
鯒	鯒	鲬
鯔	鯔	鲻
鯕	鯕	鲯
鯖	鯖	鲭
鯗	鯗	鲞
鯛	鯛	鲷
鯝	鯝	鲴
鯞	鯞	𫚡
鯡	鯡	鲱
鯢	鯢	鲵
鯤	鯤	鲲
鯧	鯧	鲳
鯨	鯨	鲸
鯪	鯪	鲮
鯫	鯫	鲰
鯬	鯬	𫚞
鯰	鯰	鲶
鯱	鯱	𩾇
鯴	鯴	鲺
鯶	鯶	𩽼
鯷	鯷	鳀
鯽	鯽	鲫
鯾	鯾	𫚣
鯿	鯿	鳊
鰁	鰁	鳈
鰂	鰂	鲗
鰃	鰃	鳂
鰆	鰆	䲠
鰈	鰈	鲽
鰉	鰉	鳇
鰋	鰋	𫚢
鰌	鰌	䲡
鰍	鰍	鳅
鰏	鰏	鲾
鰐	鰐	鳄
鰑	鰑	𫚊
鰒	鰒	鳆
鰓	鰓	鳃
鰕	鰕	𫚥
鰛	鰛	鳁
鰜	鰜	鳒
鰟	鰟	鳑
鰠	鰠	鳋
鰣	鰣	鲥
鰤	鰤	𫚕
鰥	鰥	鳏
鰦	鰦	𫚤
鰧	鰧	䲢
鰨	鰨	鳎
鰩	鰩	鳐
鰫	鰫	𫚦
鰭	鰭	鳍
鰮	鰮	鳁
鰱	鰱	鲢
鰲	鰲	鳌
鰳	鰳	鳓
鰵	鰵	鳘
鰷	鰷	鲦
鰹	鰹	鲣
鰺	鰺	鲹
鰻	鰻	鳗
鰼	鰼	鳛
鰽	鰽	𫚧
鰾	鰾	鳔
鱂	鱂	鳉
鱄	鱄	𫚋
鱅	鱅	鳙
鱆	鱆	𫠒
鱇	鱇	𩾌
鱈	鱈	鳕
鱉	鱉	鳖
鱊	鱊	𫚪
鱒	鱒	鳟
鱔	鱔	鳝
鱖	鱖	鳜
鱗	鱗	鳞
鱘	鱘	鲟
鱝	鱝	鲼
鱟	鱟	鲎
鱠	鱠	鲙
鱢	鱢	𫚫
鱣	鱣	鳣
鱤	鱤	鳡
鱧	鱧	鳢
鱨	鱨	鲿
鱭	鱭	鲚
鱮	鱮	𫚈
鱯	鱯	鳠
鱲	鱲	𫚭
鱷	鱷	鳄
鱸	鱸	鲈
鱺	鱺	鲡
鳥	鳥	鸟
鳧	鳧	凫
鳩	鳩	鸠
鳬	鳬	凫
鳲	鳲	鸤
鳳	鳳	凤
鳴	鳴	鸣
鳶	鳶	鸢
鳷	鳷	𫛛
鳼	鳼	𪉃
鳽	鳽	𫛚
鳾	鳾	䴓
鴀	鴀	𫛜
鴃	鴃	𫛞
鴅	鴅	𫛝
鴆	鴆	鸩
鴇	鴇	鸨
鴉	鴉	鸦
鴐	鴐	𫛤
鴒	鴒	鸰
鴔	鴔	𫛡
鴕	鴕	鸵
鴗	鴗	𫁡
鴛	鴛	鸳
鴜	鴜	𪉈
鴝	鴝	鸲
鴞	鴞	鸮
鴟	鴟	鸱
鴣	鴣	鸪
鴥	鴥	𫛣
鴦	鴦	鸯
鴨	鴨	鸭
鴮	鴮	𫛦
鴯	鴯	鸸
鴰	鴰	鸹
鴲	鴲	𪉆
鴳	鴳	𫛩
鴴	鴴	鸻
鴷	鴷	䴕
鴻	鴻	鸿
鴽	鴽	𫛪
鴿	鴿	鸽
鵁	鵁	䴔
鵂	鵂	鸺
鵃	鵃	鸼
鵊	鵊	𫛥
鵐	鵐	鹀
鵑	鵑	鹃
鵒	鵒	鹆
鵓	鵓	鹁
鵚	鵚	𪉍
鵜	鵜	鹈
鵝	鵝	鹅
鵟	鵟	𫛭
鵠	鵠	鹄
鵡	鵡	鹉
鵧	鵧	𫛨
鵩	鵩	𫛳
鵪	鵪	鹌
鵫	鵫	𫛱
鵬	鵬	鹏
鵮	鵮	鹐
鵯	鵯	鹎
鵰	鵰	雕 𫛲
鵲	鵲	鹊
鵷	鵷	鹓
鵾	鵾	鹍
鶄	鶄	䴖
鶇	鶇	鸫
鶉	鶉	鹑
鶊	鶊	鹒
鶌	鶌	𫛵
鶒	鶒	𫛶
鶓	鶓	鹋
鶖	鶖	鹙
鶗	鶗	𫛸
鶘	鶘	鹕
鶚	鶚	鹗
鶡	鶡	鹖
鶥	鶥	鹛
鶦	鶦	𫛷
鶩	鶩	鹜
鶪	鶪	䴗
鶬	鶬	鸧
鶭	鶭	𫛯
鶯	鶯	莺
鶰	鶰	𫛫
鶲	鶲	鹟
鶴	鶴	鹤
鶹	鶹	鹠
鶺	鶺	鹡
鶻	鶻	鹘
鶼	鶼	鹣
鶿	鶿	鹚
鷀	鷀	鹚
鷁	鷁	鹢
鷂	鷂	鹞
鷄	鷄	鸡
鷅	鷅	𫛽
鷉	鷉	䴘
鷊	鷊	鹝
鷐	鷐	𫜀
鷓	鷓	鹧
鷔	鷔	𪉑
鷖	鷖	鹥
鷗	鷗	鸥
鷙	鷙	鸷
鷚	鷚	鹨
鷣	鷣	𫜃
鷤	鷤	𫛴
鷥	鷥	鸶
鷦	鷦	鹪
鷨	鷨	𪉊
鷩	鷩	𫜁
鷫	鷫	鹔
鷯	鷯	鹩
鷲	鷲	鹫
鷳	鷳	鹇
鷴	鷴	鹇
鷷	鷷	𫜄
鷸	鷸	鹬
鷹	鷹	鹰
鷺	鷺	鹭
鷽	鷽	鸴
鷿	鷿	𬸯
鸂	鸂	㶉
鸇	鸇	鹯
鸊	鸊	䴙
鸋	鸋	𫛢
鸌	鸌	鹱
鸏	鸏	鹲
鸕	鸕	鸬
鸗	鸗	𫛟
鸘	鸘	鹴
鸚	鸚	鹦
鸛	鸛	鹳
鸝	鸝	鹂
鸞	鸞	鸾
鹵	鹵	卤
鹹	鹹	咸
鹺	鹺	鹾
鹼	鹼	碱
鹽	鹽	盐
麗	麗	丽
麥	麥	麦
麨	麨	𪎊
麩	麩	麸
麪	麪	面 麺
麫	麫	面
麬	麬	𤿲
麯	麯	曲
麲	麲	𪎉
麳	麳	𪎌
麴	麴	曲 麹
麵	麵	面 麺
麷	麷	𫜑
麼	麼	么 麽
麽	麽	么 麽
黃	黃	黄
黌	黌	黉
點	點	点
黨	黨	党
黲	黲	黪
黴	黴	霉
黶	黶	黡
黷	黷	黩
黽	黽	黾
黿	黿	鼋
鼂	鼂	鼌
鼉	鼉	鼍
鼕	鼕	冬
鼴	鼴	鼹
齊	齊	齐
齋	齋	斋
齎	齎	赍
齏	齏	齑
齒	齒	齿
齔	齔	龀
齕	齕	龁
齗	齗	龂
齙	齙	龅
齜	齜	龇
齟	齟	龃
齠	齠	龆
齡	齡	龄
齣	齣	出
齦	齦	龈
齧	齧	啮 𫜩
齩	齩	𫜪
齪	齪	龊
齬	齬	龉
齭	齭	𫜭
齯	齯	𫠜
齰	齰	𫜬
齲	齲	龋
齴	齴	𫜮
齶	齶	腭
齷	齷	龌
齾	齾	𫜰
龍	龍	龙
龎	龎	厐
龐	龐	庞
龑	龑	䶮
龓	龓	𫜲
龔	龔	龚
龕	龕	龛
龜	龜	龟
龭	龭	𩨎
龯	龯	𨱆
鿁	鿁	䜤
鿓	鿓	鿒
𠁞	𠁞	𠀾
𠌥	𠌥	𠆿
𠏢	𠏢	𠉗
𠐊	𠐊	𫝋
𠗣	𠗣	㓆
𠞆	𠞆	𠛆
𠠎	𠠎	𠚳
𠬙	𠬙	𪠡
𠽃	𠽃	𪠺
𠿕	𠿕	𪜎
𡂡	𡂡	𪢒
𡃄	𡃄	𪡺
𡃕	𡃕	𠴛
𡃤	𡃤	𪢐
𡄔	𡄔	𠴢
𡄣	𡄣	𠵸
𡅏	𡅏	𠲥
𡅯	𡅯	𪢖
𡑭	𡑭	𡋗
𡓁	𡓁	𪤄
𡓾	𡓾	𡋀
𡔖	𡔖	𡍣
𡞵	𡞵	㛟
𡟫	𡟫	𫝪
𡠹	𡠹	㛿
𡢃	𡢃	㛠
𡮉	𡮉	𡭜
𡮣	𡮣	𡭬
𡳳	𡳳	𡳃
𡸗	𡸗	𪨩
𡹬	𡹬	𪨹
𡻕	𡻕	岁
𡽗	𡽗	𡸃
𡾱	𡾱	㟜
𡿖	𡿖	𪩛
𢍰	𢍰	𪪴
𢠼	𢠼	𢙑
𢣐	𢣐	𪬚
𢣚	𢣚	𢘝
𢣭	𢣭	𢘞
𢤩	𢤩	𪫡
𢤱	𢤱	𢘙
𢤿	𢤿	𪬯
𢯷	𢯷	𪭝
𢶒	𢶒	𪭯
𢶫	𢶫	𢫞
𢷮	𢷮	𢫊
𢹿	𢹿	𢬦
𢺳	𢺳	𪮳
𣈶	𣈶	暅
𣋋	𣋋	𣈣
𣍐	𣍐	𫧃
𣙎	𣙎	㭣
𣜬	𣜬	𪳗
𣝕	𣝕	𣘷
𣞻	𣞻	𣘓
𣠩	𣠩	𣞎
𣠲	𣠲	𣑶
𣯩	𣯩	𣯣
𣯴	𣯴	𣭤
𣯶	𣯶	毶
𣽏	𣽏	𪶮
𣾷	𣾷	㳢
𣿉	𣿉	𣶫
𤁣	𤁣	𣺽
𤄷	𤄷	𪶒
𤅶	𤅶	𣷷
𤑳	𤑳	𤎻
𤑹	𤑹	𪹀
𤒎	𤒎	𤊀
𤒻	𤒻	𪹹
𤓌	𤓌	𪹠
𤓎	𤓎	𤎺
𤓩	𤓩	𤊰
𤘀	𤘀	𪺣
𤛮	𤛮	𤙯
𤛱	𤛱	𫞢
𤜆	𤜆	𪺪
𤠮	𤠮	𪺸
𤢟	𤢟	𤝢
𤢻	𤢻	𢢐
𤩂	𤩂	𫞧
𤪺	𤪺	㻘
𤫩	𤫩	㻏
𤬅	𤬅	𪼴
𤳷	𤳷	𪽝
𤳸	𤳸	𤳄
𤷃	𤷃	𪽭
𤸫	𤸫	𤶧
𤺔	𤺔	𪽴
𥊝	𥊝	𥅿
𥌃	𥌃	𥅘
𥏝	𥏝	𪿊
𥕥	𥕥	𥐰
𥖅	𥖅	𥐯
𥖲	𥖲	𪿞
𥗇	𥗇	𪿵
𥜐	𥜐	𫀓
𥜰	𥜰	𫀌
𥞵	𥞵	𥞦
𥢢	𥢢	䅪
𥢶	𥢶	𫞷
𥢷	𥢷	𫀮
𥨐	𥨐	𥧂
𥪂	𥪂	𥩺
𥯤	𥯤	𫁳
𥴨	𥴨	𫂖
𥴼	𥴼	𫁺
𥵃	𥵃	𥱔
𥵊	𥵊	𥭉
𥶽	𥶽	𫁱
𥸠	𥸠	𥮋
𥻦	𥻦	𫂿
𥼽	𥼽	𥹥
𥽖	𥽖	𥺇
𥾯	𥾯	𫄝
𥿊	𥿊	𦈈
𦀖	𦀖	𫄦
𦂅	𦂅	𦈒
𦃄	𦃄	𦈗
𦃩	𦃩	𫄯
𦅇	𦅇	𫄪
𦅈	𦅈	𫄵
𦆲	𦆲	𫟇
𦒀	𦒀	𫅥
𦔖	𦔖	𫅼
𦘧	𦘧	𡳒
𦟼	𦟼	𫆝
𦠅	𦠅	𫞅
𦡝	𦡝	𫆫
𦢈	𦢈	𣍨
𦣎	𦣎	𦟗
𦧺	𦧺	𫇘
𦪙	𦪙	䑽
𦪽	𦪽	𦨩
𦱌	𦱌	𫇪
𦾟	𦾟	𦶻
𧎈	𧎈	𧌥
𧒯	𧒯	𫊹
𧔥	𧔥	𧒭
𧕟	𧕟	𧉐
𧜗	𧜗	䘞
𧜵	𧜵	䙊
𧝞	𧝞	䘛
𧞫	𧞫	𫌋
𧟀	𧟀	𧝧
𧡴	𧡴	𫌫
𧢄	𧢄	𫌬
𧦝	𧦝	𫍞
𧦧	𧦧	𫍟
𧩕	𧩕	𫍭
𧩙	𧩙	䜥
𧩼	𧩼	𫍶
𧫝	𧫝	𫍺
𧬤	𧬤	𫍼
𧭈	𧭈	𫍾
𧭹	𧭹	𫍐
𧳟	𧳟	𧳕
𧵳	𧵳	䞌
𧶔	𧶔	𧹓
𧶧	𧶧	䞎
𧷎	𧷎	𪠀
𧸘	𧸘	𫎨
𧹈	𧹈	𪥠
𧽯	𧽯	𫎸
𨂐	𨂐	𫏌
𨄣	𨄣	𨀱
𨅍	𨅍	𨁴
𨆪	𨆪	𫏕
𨇁	𨇁	𧿈
𨇞	𨇞	𨅫
𨇤	𨇤	𫏨
𨇰	𨇰	𫏞
𨇽	𨇽	𫏑
𨈊	𨈊	𨂺
𨈌	𨈌	𨄄
𨊰	𨊰	䢀
𨊸	𨊸	䢁
𨊻	𨊻	𨐆
𨋢	𨋢	䢂
𨌈	𨌈	𫐍
𨍰	𨍰	𫐔
𨎌	𨎌	𫐋
𨎮	𨎮	𨐉
𨏠	𨏠	𨐇
𨏥	𨏥	𨐊
𨞺	𨞺	𫟫
𨟊	𨟊	𫟬
𨢿	𨢿	𨡙
𨣈	𨣈	𨡺
𨣞	𨣞	𨟳
𨣧	𨣧	𨠨
𨤻	𨤻	𨤰
𨥛	𨥛	𨱀
𨥟	𨥟	𫓫
𨦫	𨦫	䦀
𨧀	𨧀	𬭊
𨧜	𨧜	䦁
𨧰	𨧰	𫟽
𨧱	𨧱	𨱊
𨨏	𨨏	𬭛
𨨛	𨨛	𫓼
𨨢	𨨢	𫓿
𨩰	𨩰	𫟾
𨪕	𨪕	𫓮
𨫒	𨫒	𨱐
𨬖	𨬖	𫔏
𨭆	𨭆	𬭶
𨭎	𨭎	𬭳
𨭖	𨭖	𫔑
𨭸	𨭸	𫔐
𨮂	𨮂	𨱕
𨮳	𨮳	𫔒
𨯅	𨯅	䥿
𨯟	𨯟	𫔓
𨰃	𨰃	𫔉
𨰋	𨰋	𫓳
𨰥	𨰥	𫔕
𨰲	𨰲	𫔃
𨲳	𨲳	𫔖
𨳑	𨳑	𨸁
𨳕	𨳕	𨸀
𨴗	𨴗	𨸅
𨴹	𨴹	𫔲
𨵩	𨵩	𨸆
𨵸	𨵸	𨸇
𨶀	𨶀	𨸉
𨶏	𨶏	𨸊
𨶮	𨶮	𨸌
𨶲	𨶲	𨸋
𨷲	𨷲	𨸎
𨼳	𨼳	𫔽
𨽏	𨽏	𨸘
𩀨	𩀨	𫕚
𩅙	𩅙	𫕨
𩎖	𩎖	𫖑
𩎢	𩎢	𩏾
𩏂	𩏂	𫖓
𩏠	𩏠	𫖖
𩏪	𩏪	𩏽
𩏷	𩏷	𫃗
𩑔	𩑔	𫖪
𩒎	𩒎	𫖭
𩓣	𩓣	𩖕
𩓥	𩓥	𫖵
𩔑	𩔑	𫖷
𩔳	𩔳	𫖴
𩖰	𩖰	𫠇
𩗀	𩗀	𩙦
𩗓	𩗓	𫗈
𩗴	𩗴	𫗉
𩘀	𩘀	𩙩
𩘝	𩘝	𩙭
𩘹	𩘹	𩙨
𩘺	𩘺	𩙬
𩙈	𩙈	𩙰
𩚛	𩚛	𩟿
𩚥	𩚥	𩠀
𩚩	𩚩	𫗡
𩚵	𩚵	𩠁
𩛆	𩛆	𩠂
𩛌	𩛌	𫗤
𩛡	𩛡	𫗨
𩛩	𩛩	𩠃
𩜇	𩜇	𩠉
𩜦	𩜦	𩠆
𩜵	𩜵	𩠊
𩝔	𩝔	𩠋
𩝽	𩝽	𫗳
𩞄	𩞄	𩠎
𩞦	𩞦	𩠏
𩞯	𩞯	䭪
𩟐	𩟐	𩠅
𩟗	𩟗	𫗚
𩠴	𩠴	𩠠
𩡣	𩡣	𩡖
𩡺	𩡺	𩧦
𩢡	𩢡	𩧬
𩢴	𩢴	𩧵
𩢸	𩢸	𩧳
𩢾	𩢾	𩧮
𩣏	𩣏	𩧶
𩣑	𩣑	䯃
𩣫	𩣫	𩧸
𩣵	𩣵	𩧻
𩣺	𩣺	𩧼
𩤊	𩤊	𩧩
𩤙	𩤙	𩨆
𩤲	𩤲	𩨉
𩤸	𩤸	𩨅
𩥄	𩥄	𩨋
𩥇	𩥇	𩨍
𩥉	𩥉	𩧱
𩥑	𩥑	𩨌
𩦠	𩦠	𫠌
𩧆	𩧆	𩨐
𩭙	𩭙	𩬣
𩯁	𩯁	𫙂
𩯳	𩯳	𩯒
𩰀	𩰀	𩬤
𩰹	𩰹	𩰰
𩳤	𩳤	𩲒
𩴵	𩴵	𩴌
𩵦	𩵦	𫠏
𩵩	𩵩	𩽺
𩵹	𩵹	𩽻
𩶁	𩶁	𫚎
𩶘	𩶘	䲞
𩶰	𩶰	𩽿
𩶱	𩶱	𩽽
𩷰	𩷰	𩾄
𩸃	𩸃	𩾅
𩸄	𩸄	𫚝
𩸡	𩸡	𫚟
𩸦	𩸦	𩾆
𩻗	𩻗	𫚨
𩻬	𩻬	𫚩
𩻮	𩻮	𫚘
𩼶	𩼶	𫚬
𩽇	𩽇	𩾎
𩿅	𩿅	𫠖
𩿤	𩿤	𫛠
𩿪	𩿪	𪉄
𪀖	𪀖	𫛧
𪀦	𪀦	𪉅
𪀾	𪀾	𪉋
𪁈	𪁈	𪉉
𪁖	𪁖	𪉌
𪂆	𪂆	𪉎
𪃍	𪃍	𪉐
𪃏	𪃏	𪉏
𪃒	𪃒	𫛻
𪃧	𪃧	𫛹
𪄆	𪄆	𪉔
𪄕	𪄕	𪉒
𪅂	𪅂	𫜂
𪆷	𪆷	𫛾
𪇳	𪇳	𪉕
𪈼	𪈼	𱊜
𪉸	𪉸	𫜊
𪋿	𪋿	𫧮
𪌭	𪌭	𫜓
𪍠	𪍠	𫜕
𪓰	𪓰	𫜟
𪔵	𪔵	𪔭
𪘀	𪘀	𪚏
𪘯	𪘯	𪚐
𪙏	𪙏	𫜯
𪟖	𪟖	𠛾
𪷓	𪷓	𣶭
𫒡	𫒡	𫓷
𫜦	𫜦	𫜫
